1111111111111111111111111111111111
1000000000000000000000000000000001
101000000PE00000000000000000000001
1000000000000000000000000000000001
101001010010000C101001000000010101
1010010010111110001001000000101001
1000000000010000000000000000000101
1111111111111111111111111111111111